ts,p1,p2,p3,p4,sum
0,337,207,0,0,544
10,352,213,26,14,605
20,317,202,0,0,519
30,346,212,0,0,558
40,318,207,30,20,575
50,314,206,0,0,520
60,329,213,25,14,581
70,294,201,0,0,495
80,326,211,0,0,537
90,304,206,31,20,561
100,302,205,0,0,507
110,318,212,25,13,568
120,276,201,0,0,477
130,302,211,0,0,513
140,282,206,31,20,539
150,279,204,0,0,483
160,299,213,24,13,549
170,264,201,0,0,465
180,299,211,0,0,510
190,282,206,31,20,539
200,282,204,0,0,486
210,307,213,23,12,555
220,273,201,0,0,474
230,307,211,0,0,518
240,290,207,32,20,549
250,292,203,0,0,495
260,325,213,22,12,572
270,297,202,0,0,499
280,341,211,0,0,552
290,332,207,32,20,591
300,333,204,0,0,537
310,364,213,21,11,609
320,332,202,0,0,534
330,365,212,0,0,577
340,342,207,32,20,601
350,334,204,0,0,538
360,359,214,21,11,605
370,316,202,0,0,518
380,338,211,0,0,549
390,313,207,32,20,572
400,304,203,0,0,507
410,328,213,20,11,572
420,291,202,0,1,494
430,319,211,0,0,530
440,303,207,32,21,563
450,296,202,0,0,498
460,323,213,20,10,566
470,289,204,0,1,494
480,318,214,0,0,532
490,303,210,32,20,565
500,296,206,0,0,502
510,325,217,19,10,571
520,292,205,1,2,500
530,321,213,0,0,534
540,307,210,33,20,570
550,300,205,0,0,505
560,330,216,18,9,573
570,299,204,1,2,506
580,330,213,0,0,543
590,317,209,33,20,579
600,304,203,0,0,507
610,325,215,17,9,566
620,281,204,2,3,490
630,295,212,0,0,507
640,274,209,33,21,537
650,256,203,0,0,459
660,281,215,16,8,520
670,242,204,3,3,452
680,265,212,0,0,477
690,249,209,33,20,511
700,238,203,0,0,441
710,272,215,15,7,509
720,238,204,3,3,448
730,266,212,0,0,478
740,255,209,33,20,517
750,238,203,0,0,441
760,276,215,15,7,513
770,246,204,4,4,458
780,272,212,0,0,484
790,258,209,33,20,520
800,248,203,0,0,451
810,297,215,14,6,532
820,280,205,5,4,494
830,324,212,0,0,536
840,322,210,33,21,586
850,311,203,0,0,514
860,360,216,13,6,595
870,332,205,5,5,547
880,362,212,0,0,574
890,356,210,33,20,619
900,343,203,0,0,546
910,383,216,12,5,616
920,348,205,6,5,564
930,376,212,0,0,588
940,371,210,33,20,634
950,355,203,0,0,558
960,395,215,11,5,626
970,357,205,7,5,574
980,378,212,0,0,590
990,367,210,33,20,630
1000,345,202,0,0,547
1010,382,215,11,5,613
1020,343,204,7,6,560
1030,363,211,0,0,574
1040,353,210,33,20,616
1050,329,202,0,0,531
1060,362,214,10,4,590
1070,323,205,8,6,542
1080,349,211,0,0,560
1090,352,210,33,20,615
1100,330,202,0,0,532
1110,384,215,9,3,611
1120,358,205,9,7,579
1130,394,211,0,0,605
1140,410,211,33,20,674
1150,406,203,0,0,609
1160,466,215,8,3,692
1170,454,206,9,7,676
1180,500,211,0,0,711
1190,530,212,33,20,795
1200,546,203,0,0,749
1210,640,215,8,3,866
1220,649,206,11,8,874
1230,712,211,0,0,923
1240,736,212,33,20,1001
1250,736,203,0,0,939
1260,799,215,7,2,1023
1270,779,206,12,9,1006
1280,817,211,0,0,1028
1290,830,212,32,19,1093
1300,800,203,0,0,1003
1310,858,215,6,2,1081
1320,806,206,13,10,1035
1330,821,211,0,0,1032
1340,819,213,32,19,1083
1350,782,203,0,0,985
1360,844,215,5,1,1065
1370,822,207,15,11,1055
1380,887,212,0,0,1099
1390,942,213,32,19,1206
1400,976,204,0,0,1180
1410,1114,215,5,1,1335
1420,1179,207,16,12,1414
1430,1295,212,0,0,1507
1440,1389,214,32,19,1654
1450,1429,203,0,0,1632
1460,1514,215,4,0,1733
1470,1506,207,18,13,1744
1480,1525,212,0,0,1737
1490,1508,214,32,19,1773
1500,1442,204,0,0,1646
1510,1458,216,3,0,1677
1520,1394,208,19,13,1634
1530,1381,212,0,0,1593
1540,1364,214,31,18,1627
1550,1294,204,0,0,1498
1560,1302,215,3,0,1520
1570,1234,207,20,14,1475
1580,1223,211,0,0,1434
1590,1219,214,31,18,1482
1600,1171,203,0,0,1374
1610,1212,215,2,0,1429
1620,1168,207,21,15,1411
1630,1186,211,0,0,1397
1640,1201,214,31,18,1464
1650,1155,204,0,0,1359
1660,1212,215,1,0,1428
1670,1177,208,22,15,1422
1680,1201,211,0,0,1412
1690,1221,215,30,18,1484
1700,1173,204,0,0,1377
1710,1209,215,0,0,1424
1720,1154,208,23,16,1401
1730,1154,211,0,0,1365
1740,1162,215,30,17,1424
1750,1090,203,0,0,1293
1760,1120,214,0,0,1334
1770,1061,207,24,16,1308
1780,1061,209,0,0,1270
1790,1068,213,29,17,1327
1800,981,202,0,0,1183
1810,988,213,0,0,1201
1820,934,206,25,17,1182
1830,925,208,0,0,1133
1840,929,213,29,16,1187
1850,869,201,0,0,1070
1860,920,213,0,0,1133
1870,889,206,26,18,1139
1880,902,208,0,0,1110
1890,927,213,28,16,1184
1900,882,202,0,0,1084
1910,936,213,0,0,1149
1920,902,207,27,18,1154
1930,914,209,0,0,1123
1940,935,214,27,16,1192
1950,881,203,0,0,1084
1960,931,214,0,0,1145
1970,898,208,28,19,1153
1980,907,209,0,0,1116
1990,927,214,27,16,1184
2000,852,202,0,0,1054
2010,874,213,0,0,1087
2020,834,207,29,19,1089
2030,816,208,0,0,1024
2040,826,214,27,15,1082
2050,754,202,0,0,956
2060,799,213,0,0,1012
2070,762,207,29,19,1017
2080,762,207,0,0,969
2090,784,214,26,15,1039
2100,721,202,0,0,923
2110,740,213,0,0,953
2120,696,208,30,20,954
2130,679,207,0,0,886
2140,695,215,25,14,949
2150,643,203,0,0,846
2160,697,214,0,0,911
2170,670,209,30,20,929
2180,668,208,0,0,876
2190,696,215,25,14,950
2200,640,203,0,0,843
2210,682,213,0,0,895
2220,650,208,30,20,908
2230,642,207,0,0,849
2240,674,215,24,13,926
2250,619,204,0,0,823
2260,667,214,0,0,881
2270,646,209,31,20,906
2280,638,207,0,0,845
2290,669,216,23,13,921
2300,625,205,0,0,830
2310,682,214,0,0,896
2320,672,210,31,20,933
2330,679,207,0,0,886
2340,732,217,23,12,984
2350,698,205,0,0,903
2360,757,215,0,0,972
2370,739,211,31,20,1001
2380,738,208,0,0,946
2390,796,218,22,12,1048
2400,767,206,0,0,973
2410,821,216,0,0,1037
2420,799,211,32,20,1062
2430,786,208,0,0,994
2440,831,218,21,11,1081
2450,792,206,0,0,998
2460,842,215,0,0,1057
2470,824,211,32,20,1087
2480,814,207,0,0,1021
2490,845,217,21,11,1094
2500,782,206,0,1,989
2510,816,215,0,0,1031
2520,795,211,32,20,1058
2530,788,207,0,0,995
2540,849,217,20,10,1096
2550,815,206,0,1,1022
2560,872,215,0,0,1087
2570,874,211,32,20,1137
2580,885,207,0,0,1092
2590,956,217,19,10,1202
2600,921,206,0,1,1128
2610,971,215,0,0,1186
2620,948,211,32,20,1211
2630,919,206,0,0,1125
2640,965,217,18,9,1209
2650,914,206,1,2,1123
2660,955,215,0,0,1170
2670,926,211,32,20,1189
2680,892,206,0,0,1098
2690,929,217,17,9,1172
2700,873,206,1,2,1082
2710,911,215,0,0,1126
2720,899,211,32,20,1162
2730,892,205,0,0,1097
2740,964,217,16,8,1205
2750,944,206,2,2,1154
2760,1022,214,0,0,1236
2770,1031,211,33,20,1295
2780,1033,205,0,0,1238
2790,1116,216,16,7,1355
2800,1075,206,3,3,1287
2810,1107,214,0,0,1321
2820,1077,211,33,20,1341
2830,1020,205,0,0,1225
2840,1024,217,15,7,1263
2850,932,206,3,3,1144
2860,942,214,0,0,1156
2870,898,211,33,20,1162
2880,836,204,0,0,1040
2890,846,216,14,7,1083
2900,771,205,4,4,984
2910,783,213,0,0,996
2920,753,211,33,20,1017
2930,712,204,0,0,916
2940,756,217,13,6,992
2950,707,207,5,5,924
2960,745,214,0,0,959
2970,741,211,33,20,1005
2980,729,204,0,0,933
2990,803,217,12,5,1037
3000,780,206,6,5,997
3010,842,214,0,0,1056
3020,856,211,33,20,1120
3030,854,205,0,0,1059
3040,928,217,11,5,1161
3050,895,207,6,5,1113
3060,924,214,0,0,1138
3070,902,212,33,20,1167
3080,854,205,0,0,1059
3090,895,217,11,5,1128
3100,835,207,7,6,1055
3110,846,214,0,0,1060
3120,820,212,33,20,1085
3130,776,205,0,0,981
3140,817,217,10,4,1048
3150,764,207,8,6,985
3160,795,214,0,0,1009
3170,799,213,33,20,1065
3180,767,205,0,0,972
3190,807,217,9,3,1036
3200,747,207,8,7,969
3210,760,214,0,0,974
3220,721,213,33,20,987
3230,660,205,0,0,865
3240,682,217,8,3,910
3250,609,208,10,7,834
3260,623,213,0,0,836
3270,602,214,33,20,869
3280,548,205,0,0,753
3290,581,217,7,2,807
3300,531,207,11,8,757
3310,548,213,0,0,761
3320,540,214,33,20,807
3330,500,205,0,0,705
3340,538,216,7,2,763
3350,491,207,12,9,719
3360,511,212,0,0,723
3370,516,214,32,20,782
3380,478,204,0,0,682
3390,529,216,6,1,752
3400,491,206,14,10,721
3410,509,211,0,0,720
3420,500,212,32,20,764
3430,455,202,0,0,657
3440,496,213,5,1,715
3450,453,205,15,11,684
3460,469,209,0,0,678
3470,475,211,32,19,737
3480,432,201,0,0,633
3490,474,213,5,1,693
3500,431,204,17,12,664
3510,450,209,0,0,659
3520,457,211,32,19,719
3530,417,201,0,0,618
3540,466,212,4,0,682
3550,430,204,18,13,665
3560,452,209,0,0,661
3570,464,211,31,19,725
3580,431,201,0,0,632
3590,486,213,3,0,702
3600,452,205,19,14,690
3610,477,209,0,0,686
3620,495,212,31,18,756
3630,461,201,0,0,662
3640,511,213,2,0,726
3650,474,205,21,15,715
3660,494,209,0,0,703
3670,508,212,31,18,769
3680,467,201,0,0,668
3690,516,212,2,0,730
3700,481,205,22,15,723
3710,499,208,0,0,707
3720,515,212,30,18,775
3730,474,201,0,0,675
3740,525,212,1,0,738
3750,494,206,22,15,737
3760,514,208,0,0,722
3770,534,213,30,17,794
3780,491,201,0,0,692
3790,540,213,0,0,753
3800,515,207,24,16,762
3810,547,210,0,0,757
3820,579,215,30,17,841
3830,540,203,0,0,743
3840,597,215,0,0,812
3850,569,208,24,17,818
3860,586,210,0,0,796
3870,612,215,29,17,873
3880,567,203,0,0,770
3890,623,214,0,0,837
3900,594,207,25,17,843
3910,614,210,0,0,824
3920,643,214,28,16,901
3930,604,203,0,0,807
3940,658,214,0,0,872
3950,630,208,27,18,883
3960,649,210,0,0,859
3970,679,215,28,16,938
3980,640,203,0,0,843
3990,699,214,0,0,913
4000,675,208,27,19,929
4010,690,209,0,0,899
4020,713,215,27,16,971
4030,666,203,0,0,869
4040,719,214,0,0,933
4050,697,208,28,19,952
4060,703,209,0,0,912
4070,723,215,27,15,980
4080,678,203,0,0,881
4090,741,214,0,0,955
4100,726,208,29,19,982
4110,741,209,0,0,950
4120,780,215,26,15,1036
4130,743,203,0,0,946
4140,798,214,0,0,1012
4150,769,208,29,20,1026
4160,772,208,0,0,980
4170,800,215,26,15,1056
4180,752,203,0,0,955
4190,798,213,0,0,1011
4200,767,208,30,20,1025
4210,766,207,0,0,973
4220,793,214,25,14,1046
4230,739,203,0,0,942
4240,782,213,0,0,995
4250,752,208,30,20,1010
4260,749,206,0,0,955
4270,778,214,24,13,1029
4280,724,202,0,0,926
4290,761,213,0,0,974
4300,725,208,30,20,983
4310,713,206,0,0,919
4320,736,214,24,13,987
4330,680,203,0,0,883
4340,723,214,0,0,937
4350,703,209,31,20,963
4360,696,207,0,0,903
4370,728,216,23,12,979
4380,678,205,0,0,883
4390,719,215,0,0,934
4400,694,210,31,20,955
4410,689,207,0,0,896
4420,727,217,22,12,978
4430,677,206,0,0,883
4440,717,215,0,0,932
4450,693,211,32,20,956
4460,682,208,0,0,890
4470,722,217,21,12,972
4480,674,206,0,0,880
4490,722,215,0,0,937
4500,703,211,32,20,966
4510,694,208,0,0,902
4520,730,218,20,11,979
4530,672,206,0,0,878
4540,705,216,0,0,921
4550,672,211,32,20,935
4560,645,207,0,0,852
4570,676,218,20,11,925
4580,606,206,0,1,813
4590,627,215,0,0,842
4600,587,211,32,20,850
4610,558,207,0,0,765
4620,576,217,19,10,822
4630,502,206,0,1,709
4640,522,215,0,0,737
4650,489,211,32,20,752
4660,460,206,0,0,666
4670,483,217,18,9,727
4680,429,206,0,2,637
4690,469,215,0,0,684
4700,454,211,32,20,717
4710,445,206,0,0,651
4720,492,217,18,9,736
4730,449,206,1,2,658
4740,491,215,0,0,706
4750,482,211,32,20,745
4760,469,205,0,0,674
4770,524,217,16,8,765
4780,484,206,2,2,694
4790,526,214,0,0,740
4800,509,211,33,20,773
4810,498,205,0,0,703
4820,549,217,16,7,789
4830,500,206,3,3,712
4840,536,214,0,0,750
4850,525,211,33,20,789
4860,516,205,0,0,721
4870,588,217,15,7,827
4880,561,207,3,3,774
4890,617,214,0,0,831
4900,618,211,33,20,882
4910,605,205,0,0,810
4920,659,217,14,6,896
4930,611,207,4,4,826
4940,647,214,0,0,861
4950,637,212,33,20,902
4960,619,205,0,0,824
4970,677,217,13,6,913
4980,647,207,5,5,864
4990,710,214,0,0,924
5000,710,211,33,20,974
5010,682,205,0,0,887
5020,740,217,12,6,975
5030,708,207,5,5,925
5040,752,214,0,0,966
5050,748,212,33,20,1013
5060,727,205,0,0,932
5070,783,217,12,5,1017
5080,726,207,6,5,944
5090,743,214,0,0,957
5100,720,212,33,20,985
5110,684,205,0,0,889
5120,736,217,11,5,969
5130,695,207,7,6,915
5140,738,214,0,0,952
5150,736,212,33,20,1001
5160,713,205,0,0,918
5170,775,217,10,4,1006
5180,733,207,8,6,954
5190,767,213,0,0,980
5200,764,212,33,20,1029
5210,729,205,0,0,934
5220,778,217,9,3,1007
5230,732,207,8,6,953
5240,753,214,0,0,967
5250,738,213,33,20,1004
5260,697,205,0,0,902
5270,727,217,9,3,956
5280,668,208,9,7,892
5290,687,214,0,0,901
5300,675,214,33,20,942
5310,638,205,0,0,843
5320,678,217,8,3,906
5330,619,208,10,8,845
5340,640,213,0,0,853
5350,636,214,33,20,903
5360,597,205,0,0,802
5370,645,217,7,2,871
5380,602,208,12,9,831
5390,626,213,0,0,839
5400,623,214,32,20,889
5410,579,205,0,0,784
5420,619,217,6,2,844
5430,574,208,13,10,805
5440,600,213,0,0,813
5450,608,215,32,20,875
5460,572,205,0,0,777
5470,622,217,6,1,846
5480,578,208,14,11,811
5490,608,213,0,0,821
5500,625,215,32,19,891
5510,598,205,0,0,803
5520,659,217,5,1,882
5530,622,209,16,11,858
5540,649,214,0,0,863
5550,662,216,32,19,929
5560,625,206,0,0,831
5570,679,217,4,1,901
5580,641,209,17,12,879
5590,664,213,0,0,877
5600,674,215,31,19,939
5610,635,205,0,0,840
5620,691,217,3,0,911
5630,667,209,19,13,908
5640,706,213,0,0,919
5650,737,215,31,19,1002
5660,707,205,0,0,912
5670,776,216,3,0,995
5680,749,209,20,14,992
5690,784,213,0,0,997
5700,803,216,31,18,1068
5710,764,206,0,0,970
5720,822,217,2,0,1041
5730,797,209,21,15,1042
5740,838,213,0,0,1051
5750,876,216,31,18,1141
5760,847,205,0,0,1052
5770,911,217,2,0,1130
5780,882,210,21,15,1128
5790,904,213,0,0,1117
5800,919,216,30,18,1183
5810,868,205,0,0,1073
5820,923,216,1,0,1140
5830,896,210,23,16,1145
5840,930,213,0,0,1143
5850,963,217,30,18,1228
5860,939,206,0,0,1145
5870,1014,216,0,0,1230
5880,996,209,23,16,1244
5890,1014,212,0,0,1226
5900,1030,217,30,17,1294
5910,978,205,0,0,1183
5920,1028,216,0,0,1244
5930,985,210,24,16,1235
5940,997,212,0,0,1209
5950,1022,217,29,17,1285
5960,989,205,0,0,1194
5970,1083,216,0,0,1299
5980,1079,209,25,17,1330
5990,1116,212,0,0,1328
6000,1176,217,29,16,1438
6010,1162,205,0,0,1367
6020,1276,216,0,0,1492
6030,1288,210,26,18,1542
6040,1346,212,0,0,1558
6050,1416,217,28,16,1677
6060,1400,205,0,0,1605
6070,1477,216,0,0,1693
6080,1475,210,27,18,1730
6090,1521,212,0,0,1733
6100,1561,217,28,16,1822
6110,1507,205,0,0,1712
6120,1562,216,0,0,1778
6130,1539,210,28,19,1796
6140,1558,211,0,0,1769
6150,1595,217,27,15,1854
6160,1550,205,0,0,1755
6170,1617,216,0,0,1833
6180,1599,210,29,19,1857
6190,1618,211,0,0,1829
6200,1658,217,26,15,1916
6210,1612,205,0,0,1817
6220,1658,216,0,0,1874
6230,1621,210,29,19,1879
6240,1619,211,0,0,1830
6250,1638,217,26,15,1896
6260,1552,206,0,0,1758
6270,1567,216,0,0,1783
6280,1483,210,29,20,1742
6290,1422,210,0,0,1632
6300,1406,217,25,14,1662
6310,1323,205,0,0,1528
6320,1370,216,0,0,1586
6330,1374,210,30,20,1634
6340,1417,210,0,0,1627
6350,1549,217,24,14,1804
6360,1603,206,0,0,1809
6370,1763,216,0,0,1979
6380,1854,211,30,20,2115
6390,1944,209,0,0,2153
6400,2105,217,24,13,2359
6410,2172,206,0,0,2378
6420,2319,216,0,0,2535
6430,2384,211,31,20,2646
6440,2417,210,0,0,2627
6450,2502,218,23,13,2756
6460,2445,206,0,0,2651
6470,2446,216,0,0,2662
6480,2331,211,31,20,2593
6490,2211,209,0,0,2420
6500,2147,218,23,12,2400
6510,1977,207,0,0,2184
6520,1921,216,0,0,2137
6530,1813,212,31,20,2076
6540,1737,209,0,0,1946
6550,1743,218,22,12,1995
6560,1681,207,0,0,1888
6570,1741,216,0,0,1957
6580,1750,212,31,20,2013
6590,1773,208,0,0,1981
6600,1845,218,21,11,2095
6610,1814,207,0,0,2021
6620,1874,216,0,0,2090
6630,1849,212,32,20,2113
6640,1822,208,0,0,2030
6650,1860,218,21,11,2110
6660,1790,207,0,0,1997
6670,1831,216,0,0,2047
6680,1812,212,32,20,2076
6690,1798,208,0,0,2006
6700,1857,218,20,10,2105
6710,1816,207,0,1,2024
6720,1873,215,0,0,2088
6730,1865,211,32,20,2128
6740,1852,207,0,0,2059
6750,1899,217,20,10,2146
6760,1848,206,0,1,2055
6770,1893,215,0,0,2108
6780,1884,211,32,20,2147
6790,1878,207,0,0,2085
6800,1954,218,19,10,2201
6810,1921,207,0,1,2129
6820,1983,215,0,0,2198
6830,1985,212,32,20,2249
6840,1978,207,0,0,2185
6850,2041,218,18,9,2286
6860,1995,207,1,2,2205
6870,2051,215,0,0,2266
6880,2050,212,32,20,2314
6890,2038,207,0,0,2245
6900,2111,218,17,9,2355
6910,2076,207,1,2,2286
6920,2126,215,0,0,2341
6930,2114,212,32,20,2378
6940,2081,206,0,0,2287
6950,2124,218,16,8,2366
6960,2029,207,2,3,2241
6970,2021,215,0,0,2236
6980,1948,212,32,20,2212
6990,1842,206,0,0,2048
7000,1806,218,15,7,2046
7010,1664,207,2,3,1876
7020,1622,215,0,0,1837
7030,1540,212,33,20,1805
7040,1458,206,0,0,1664
7050,1479,218,15,7,1719
7060,1396,207,4,3,1610
7070,1415,214,0,0,1629
7080,1388,212,33,20,1653
7090,1366,206,0,0,1572
7100,1441,217,14,6,1678
7110,1399,207,4,4,1614
7120,1390,214,0,0,1604
7130,1306,212,33,20,1571
7140,1230,206,0,0,1436
7150,1245,217,13,6,1481
7160,1145,207,5,4,1361
7170,1126,214,0,0,1340
7180,1036,212,33,20,1301
7190,896,206,0,0,1102
7200,816,217,12,6,1051
7210,630,207,6,5,848
7220,537,214,0,0,751
7230,430,212,33,20,695
7240,339,205,0,0,544
7250,303,217,12,5,537
7260,237,208,7,5,457
7270,221,214,0,0,435
7280,183,212,34,21,450
7290,159,206,0,0,365
7300,153,216,11,5,385
7310,127,208,7,6,348
7320,133,213,0,0,346
7330,119,212,34,21,386
7340,106,206,0,0,312
7350,106,216,10,4,336
7360,92,209,8,7,316
7370,100,213,0,0,313
7380,91,212,34,21,358
7390,82,207,0,0,289
7400,84,215,9,4,312
7410,72,209,9,7,297
7420,86,213,0,0,299
7430,82,212,34,21,349
7440,80,207,0,0,287
7450,90,215,9,3,317
7460,81,209,10,7,307
7470,101,214,0,0,315
7480,115,213,34,20,382
7490,129,207,0,0,336
7500,149,215,8,3,375
7510,145,209,10,8,372
7520,150,214,0,0,364
7530,139,213,34,20,406
7540,136,208,0,0,344
7550,145,215,7,2,369
7560,136,209,12,9,366
7570,149,213,0,0,362
7580,147,213,34,20,414
7590,144,207,0,0,351
7600,149,215,6,2,372
7610,139,210,13,9,371
7620,150,213,0,0,363
7630,141,213,33,20,407
7640,132,207,0,0,339
7650,139,214,6,1,360
7660,126,210,14,11,361
7670,125,213,0,0,338
7680,112,213,33,20,378
7690,102,207,0,0,309
7700,109,214,5,1,329
7710,98,210,16,11,335
7720,105,213,0,0,318
7730,96,213,33,20,362
7740,87,208,0,0,295
7750,94,215,4,0,313
7760,86,210,17,12,325
7770,98,214,0,0,312
7780,96,214,33,20,363
7790,95,208,0,0,303
7800,105,215,3,0,323
7810,96,210,18,13,337
7820,105,214,0,0,319
7830,103,214,33,19,369
7840,99,208,0,0,307
7850,107,215,3,0,325
7860,101,210,20,14,345
7870,110,213,0,0,323
7880,102,213,32,19,366
7890,94,208,0,0,302
7900,106,214,2,0,322
7910,100,210,21,15,346
7920,109,213,0,0,322
7930,105,214,32,19,370
7940,99,207,0,0,306
7950,108,214,1,0,323
7960,99,210,21,15,345
7970,106,212,0,0,318
7980,104,214,32,18,368
7990,100,207,0,0,307
8000,109,214,1,0,324
8010,102,210,23,16,351
8020,109,212,0,0,321
8030,105,214,31,18,368
8040,99,207,0,0,306
8050,108,214,0,0,322
8060,97,210,24,16,347
8070,102,212,0,0,314
8080,97,214,30,18,359
8090,86,207,0,0,293
8100,90,214,0,0,304
8110,74,210,24,17,325
8120,78,212,0,0,290
8130,77,214,30,17,338
8140,69,207,0,0,276
8150,77,214,0,0,291
8160,72,210,25,17,324
8170,82,212,0,0,294
8180,82,214,30,17,343
8190,77,207,0,0,284
8200,88,213,0,0,301
8210,81,210,27,18,336
8220,91,212,0,0,303
8230,90,213,29,17,349
8240,84,207,0,0,291
8250,93,213,0,0,306
8260,85,210,27,18,340
8270,92,212,0,0,304
8280,91,213,29,17,350
8290,83,207,0,0,290
8300,92,213,0,0,305
8310,83,210,29,19,341
8320,91,211,0,0,302
8330,92,214,29,16,351
8340,86,207,0,0,293
8350,90,213,0,0,303
8360,78,210,29,19,336
8370,82,211,0,0,293
8380,79,214,28,16,337
8390,70,207,0,0,277
8400,81,213,0,0,294
8410,72,210,30,20,332
8420,81,211,0,0,292
8430,85,214,27,15,341
8440,82,207,0,0,289
8450,93,213,0,0,306
8460,83,210,30,20,343
8470,88,211,0,0,299
8480,89,214,26,15,344
8490,84,207,0,0,291
8500,94,213,0,0,307
8510,86,210,30,20,346
8520,93,211,0,0,304
8530,95,214,26,14,349
8540,90,207,0,0,297
8550,100,214,0,0,314
8560,94,210,31,20,355
8570,99,211,0,0,310
8580,101,214,26,14,355
8590,94,208,0,0,302
8600,104,214,0,0,318
8610,95,210,31,20,356
8620,94,210,0,0,304
8630,90,214,25,13,342
8640,78,208,0,0,286
8650,85,214,0,0,299
8660,77,210,31,20,338
8670,83,210,0,0,293
8680,88,214,24,13,339
8690,82,207,0,0,289
8700,93,214,0,0,307
8710,83,211,32,20,346
8720,88,210,0,0,298
8730,91,214,23,13,341
8740,79,208,0,0,287
8750,86,214,0,0,300
8760,82,210,32,21,345
8770,93,209,0,0,302
8780,100,214,23,12,349
8790,93,208,0,0,301
8800,102,214,0,0,316
8810,96,210,32,21,359
8820,100,209,0,0,309
8830,102,214,22,11,349
8840,93,208,0,0,301
8850,103,213,0,0,316
8860,97,210,33,21,361
8870,100,209,0,0,309
8880,104,214,21,11,350
8890,95,208,0,1,304
8900,104,213,0,0,317
8910,94,210,33,21,358
8920,94,208,0,0,302
8930,96,214,20,10,340
8940,87,207,0,1,295
8950,98,213,0,0,311
8960,91,210,33,21,355
8970,95,208,0,0,303
8980,99,214,20,10,343
8990,92,207,0,1,300
9000,102,213,0,0,315
9010,95,210,33,21,359
9020,97,208,0,0,305
9030,103,214,19,10,346
9040,96,207,1,2,306
9050,106,213,0,0,319
9060,99,210,33,21,363
9070,104,207,0,0,311
9080,112,214,18,9,353
9090,106,207,1,2,316
9100,119,213,0,0,332
9110,113,210,34,21,378
9120,117,207,0,0,324
9130,124,214,17,8,363
9140,117,207,2,3,329
9150,128,213,0,0,341
9160,121,210,34,21,386
9170,119,207,0,0,326
9180,120,214,16,8,358
9190,105,208,3,3,319
9200,110,213,0,0,323
9210,101,210,33,21,365
9220,97,207,0,0,304
9230,98,214,15,7,334
9240,87,208,3,4,302
9250,96,213,0,0,309
9260,87,210,34,21,352
9270,85,207,0,0,292
9280,88,214,15,7,324
9290,76,208,5,4,293
9300,80,213,0,0,293
9310,68,210,34,21,333
9320,65,207,0,0,272
9330,68,214,14,6,302
9340,56,208,5,5,274
9350,64,213,0,0,277
9360,55,210,34,21,320
9370,53,207,0,0,260
9380,62,214,13,6,295
9390,54,208,5,5,272
9400,65,213,0,0,278
9410,60,210,34,21,325
9420,62,207,0,0,269
9430,72,214,12,5,303
9440,67,208,6,5,286
9450,83,213,0,0,296
9460,82,210,34,21,347
9470,85,207,0,0,292
9480,94,214,12,5,325
9490,84,208,7,6,305
9500,89,213,0,0,302
9510,77,210,34,21,342
9520,71,207,0,0,278
9530,77,214,11,5,307
9540,69,209,8,6,292
9550,78,213,0,0,291
9560,72,211,34,21,338
9570,72,207,0,0,279
9580,79,214,10,4,307
9590,71,209,8,6,294
9600,79,213,0,0,292
9610,72,211,34,21,338
9620,71,207,0,0,278
9630,80,214,9,3,306
9640,71,209,9,7,296
9650,83,213,0,0,296
9660,79,211,34,21,345
9670,81,207,0,0,288
9680,91,214,9,3,317
9690,84,209,10,7,310
9700,94,213,0,0,307
9710,86,212,34,20,352
9720,83,207,0,0,290
9730,90,214,8,3,315
9740,82,209,10,7,308
9750,91,213,0,0,304
9760,84,212,34,20,350
9770,81,207,0,0,288
9780,87,214,7,2,310
9790,78,209,11,8,306
9800,86,213,0,0,299
9810,81,212,34,20,347
